; DOOM 2D Atari map
; Saved by mapedit.py
;sky=DFSKY0
;SWITCH 18,3 -> 11,3 door
;SWITCH 18,10 -> 9,7 door
;SWITCH 10,7 -> 9,7 door
--------------------............
-........q.........-............
-PPPPPPPPqqqq......-............
-..P.....qCD....uw6-............
-..}k....q---.------............
-.YYYYYYYq.........-............
-o....Y..q...o.....-............
-.!5RH|..D..wo.....-............
-ooooooo.qqqqqqqqqq-............
-.......oq.........-............
-@......zDI.....H.$-............
oooooooooooooooooooo............
................................
................................
................................
................................
................................
................................
................................
................................
................................
................................
................................
................................
................................
................................
................................
................................
................................
................................
................................
................................
