; DOOM 2D Atari map
; Saved by mapedit.py
;sky=D2DSKY1
#~~~~~~~~~~~~~~~~~~~~~~~~~~~~~~~~~~~~~~~~~~~~~~~~~~~~~~~~~~~~~~#
#~~~~~~~~~~~~~~~~~~~~~~~~~~~~~~~~~~~~~~~~~~~~~~~~~~~~~~~~~~~~~~#
################################################################
#..............................................................#
#..............................................................#
#..............................................................#
#..............................................................#
#..............................................................#
#..............................................................#
#..............................................................#
#.@............................................................#
#==============================================================#
#..............................................................#
#..............................................................#
#..............................................................#
#..............................................................#
#..............................................................#
#..............................................................#
#..............................................................#
#..............................................................#
#..............................................................#
#..............................................................#
#..............................................................#
#..............................................................#
#..............................................................#
#..............................................................#
#..............................................................#
#..............................................................#
#..............................................................#
#..............................................................#
#..............................................................#
################################################################
