; DOOM 2D Atari map
; Saved by mapedit.py
T~~~~~~~~~~~~~~~~~~T############################################
T~~~~~~~~~~~~~~~~~~T############################################
T~~~~~~~~~~~~~~~~~~T############################################
T~~~~~~~~~~~~~~~~~~T############################################
T~~~~~~~~~~~~~~~~~~T############################################
GGGGGGGGGGGGGGGGGGGE############################################
GGGGGGGGGGGGGGGGGGEE############################################
GGGGGGGGGEGGGGGEEEGE############################################
EEEEEEEEEEEEEEEEEEEE############################################
EEEEEEEEEEEEEEEEEEEE############################################
E@7EEEEEEEEEEEEEEEKE############################################
====================###########################################.
################################################################
################################################################
################################################################
################################################################
################################################################
################################################################
################################################################
################################################################
################################################################
################################################################
################################################################
################################################################
################################################################
################################################################
################################################################
################################################################
################################################################
################################################################
################################################################
################################################################
