; DOOM 2D Atari map
; Saved by mapedit.py
T~~~~~~~~~~~~~~~~~~T############################################
T~~~~~~~~~~~~~~~~~~T############################################
T~~~~~~~~~~~~~~~~~~T############################################
T~~~~~~~~~~~~~~~~~~T############################################
T~~~~~~~~~~~~~~~~~~T############################################
TbbbbbbbbbbbbbbbbbbT############################################
TbbbbbbbbbbbbbbbbbbT############################################
TbbbbbbbbbbbbbbbbbbT############################################
TbbbbbbbbbbbbbbbbbbT############################################
TbbbbbbbbbbbbbbbbbbT############################################
Tr@RbbQbb99WZbB9bIbT############################################
====================###########################################.
################################################################
################################################################
################################################################
################################################################
################################################################
################################################################
################################################################
################################################################
################################################################
################################################################
################################################################
################################################################
################################################################
################################################################
################################################################
################################################################
################################################################
################################################################
################################################################
################################################################
