; DOOM 2D Atari map
; Saved by mapedit.py
-~~~~~~~~~~~~~~~~~~-############################################
-~~~~~~~~~~~~~~~~~~-############################################
-~~~~~~~~~~~~~~~~~~-############################################
-~~~~~~~~~~~~~~~~~~-############################################
-~~~~~~~~~~~~~~~~~~-############################################
EEEEEEEEEEEEEEEEEEEE############################################
EEVEEEEEEEEEEEEVEEEE############################################
EEEEEEEEEEEEEEEEEEEE############################################
EEEEEEEEEEEEEEEEEEEE############################################
EEE@EEEEEEEEVEEEEEEE############################################
9QEEEEEEEEEEEEEIEEEZ############################################
YYYYYYYYYYYYYYYYYYYY###########################################.
################################################################
################################################################
################################################################
################################################################
################################################################
################################################################
################################################################
################################################################
################################################################
################################################################
################################################################
################################################################
################################################################
################################################################
################################################################
################################################################
################################################################
################################################################
################################################################
################################################################
